|   X   |   |   
|   Y   |   |   
|   Z   |   |   
H   |   |   |   
|   Rx  |   |   
|   Ry  |   |   
|   Rz  |   |   
|   |   R   |   
|   @P  |   |   
|   @P  |   |   
|   @P  |   |   
|   @P  |   |   
@---+---X   |   
PRINT	ALL
<---+--->   |   
@---+---@P  |   
@---+---@P  |   
O---O---@---Ry  
